新华社受权于18日全文播发修改后的《中华人民共和国立法法》，修改后的立法法分为“总则”“法律”“行政法规”“地方性法规、自治条例和单行条例、规章”“适用与备案审查”“附则”等6章，共计105条。	修改后的立法法全文公布
一辆小轿车，一名女司机，竟造成9死24伤。日前，深圳市交警局对事故进行通报：从目前证据看，事故系司机超速行驶且操作不当导致。目前24名伤员已有6名治愈出院，其余正接受治疗，预计事故赔偿费或超一千万元。	深圳机场9死24伤续：司机全责赔偿或超千万
1月18日，习近平总书记对政法工作作出重要指示：2014年，政法战线各项工作特别是改革工作取得新成效。新形势下，希望全国政法机关主动适应新形势，为公正司法和提高执法司法公信力提供有力制度保障。	孟建柱：主动适应形势新变化提高政法机关服务大局的能力
针对央视3·15晚会曝光的电信行业乱象，工信部在公告中表示，将严查央视3·15晚会曝光通信违规违法行为。工信部称，已约谈三大运营商有关负责人，并连夜责成三大运营商和所在省通信管理局进行调查，依法依规严肃处理。	工信部约谈三大运营商严查通信违规
国家食药监管总局近日发布《食品召回管理办法》，明确：食用后已经或可能导致严重健康损害甚至死亡的，属一级召回，食品生产者应在知悉食品安全风险后24小时内启动召回，且自公告发布之日起10个工作日内完成召回。	食品一级召回限24小时内启动10工作日完成
人民检察院刑事诉讼涉案财物管理规定明确，不得查封、扣押、冻结与案件无关的财物，严禁在立案前查封、扣押、冻结财物，对查明确实与案件无关的，应当在三日内予以解除、退还。	最高检:诉讼未终结涉案财物不得上缴国库
聂树斌案的复查有了新进展，山东高院已正式通知聂树斌案申诉代理律师阅卷。这也是该案律师10年来首次获准阅卷。此前山东省高院复查聂树斌案合议庭成员提讯了王书金，其仍坚称石家庄西郊玉米地强奸杀人案是他所为。	聂树斌案律师10年来首获准阅卷
近日北京市司法局、北京市检察院联合召开人民监督员选任管理方式改革工作会议，宣布了北京市第一届113名人民监督员的任命决定，并组织监督员向宪法集体宣誓。人民监督员以“第三方”去监督检察院办案，机制上做到了相互制衡。	北京市第一届人民监督员向宪法集体宣誓
据315晚会报道，公共免费WIFI存在隐患。黑客可利用轻易盗取用户个人信息，如账号、密码等。为了保证您个人信息安全，在公共场所尽量不要使用那些不需要密码免费wifi。	免费公共wifi存隐患黑客可轻易获取用户信息
3月12日，最高人民法院院长周强作最高人民法院工作报告。周强表示，去年各级法院再审改判刑事案件1317件，其中纠正一批重大冤假错案。对错案的发生，我们深感自责，要求各级法院深刻汲取教训……更多工作报告要点详见↓	一张图看懂最高法2014年工作报告
如今，用手机软件叫“代驾”是件时尚而方便的事情，可是一旦发生交通事故，车主、代驾人、手机代驾软件及保险公司，究竟由谁来付“代价”？上海浦东新区法院9日宣判一起新类型案件，软件运行公司被判担责。	全国首例涉代驾软件交通事故案宣判
中央全面深化改革领导小组第十次会议审议通过了《深化人民监督员制度改革方案》，提出由司法行政机关负责人民监督员的选任和培训等管理工作，解决了检察机关“自己选人监督自己”的问题，使人民监督员的监督更有说服力....>>	全面深化人民监督员制度改革
（民主与法制网）“老赖”，就是欠钱不还的人。老赖如同阳光下的隐形人，人人喊打但无迹可寻，数量不多甚至寥寥可数，却是让社会头痛的“老大难”。曾有一位法院工作人员对记者无奈地表示：“这些老赖一而再再而三地推脱赖账，很多案件一时难以执行下去。	多部门联合捉“老赖”
国家税务总局透露，去年税务协同公安等部门共查处发票违法犯罪案件10.2万起，抓获犯罪嫌疑人6014人，缴获假发票6449万份。其中税务部门查处违法企业9.9万户，查补税款106亿元，加收滞纳金10亿元，罚款和没收违法所得18亿元。	去年全国查处发票违法犯罪案件10.2万起
环保部决定对存在各类问题的63家建设项目环评机构和22名环评工程师分别作出了取消资质、缩减评价范围、限期整改、通报批评等相应处理。要求所有具有环保部门背景的环评单位全面退出建设项目环评技术服务市场，彻底解决“红顶中介”问题。	环保部要求有背景单位退出环评市场
最高法５日公布《关于民事审判监督程序严格依法适用指令再审和发回重审若干问题的规定》，规范民事案件指令再审和发回重审的标准，确保再审程序充分发挥依法纠错功能。该司法解释自２０１５年３月１５日起施行	最新司法解释：确保民事案件再审程序充分发挥纠错功能
4日，最高法、最高检、公安部和司法部联合发布《关于依法办理家庭暴力犯罪案件的意见》，意见明确，对正在进行的家庭暴力采取制止行为，只要符合刑法规定的条件，就应当依法认定为正当防卫，不负刑事责任。	四部门明确认定家暴正当防卫：免刑罚或轻判
对于消费者网购后悔权，即“七天内无理由可退货”，商家常以“已拆封”等为由拒绝执行。3月15日起，国家工商总局明确规定，“已拆封”不得作为拒退货理由，故意拒绝或拖延退货商家最高将受到50万元处罚。	工商总局：“已拆封”不能作为拒退货理由
从选种、育苗、种植、田间管理、加工方法、到冲泡手法等，福山咖啡有一套非常完备的专业技术，福山咖啡品质与口味始终如一。在2015年海报集团年货展上，澄迈福山咖啡联合公司将带着浓郁的福山咖啡给前来展会的市民品尝。	澄迈福山咖啡口感纯正，想尝尝吗
最近，中国载人航天网发布了长征7号火箭矗立在文昌新型移动发射平台上的照片。据悉，长征7号火箭可能在2016年进行首次发射，身处海南亲们到时候记得到文昌围观火箭发射哦~	长征7号来了可以在文昌围观火箭发射咯
周末采摘杨桃助农，游玩澄迈养生农庄自驾活动，快来报名~1月31日早上8点半出发哦，前往澄迈杨桃园采摘，入园免费，漫山遍野的杨桃和你亲密接触（带走的按2.5元/斤）。报名方式：拨136-3755-3497报名，或戳链接	这个周末自驾游去摘杨桃啦！
海南省质量技术监督局近日通报了《2014年烟花爆竹产品质量省级监督抽查结果》，海南有2家企业4种产品烟花爆竹不合格，防安、好日子商标名列其中。戳链接查看具体贵规格型号大家要认准了，别买到不合格的哦	好日子是“车大炮”？过年这些鞭炮你们别买
海口秀英长流镇墟上的杨小姐寄包裹却遭快递员调戏：让我亲一口就不收你钱。寄个快递，没想到却被快递员出言调戏。丈夫上门讨说法，却还快递员带一伙人手持长棍大刀石头砸了自己的车。	海口快递小哥：让我亲一口就不收你钱！
歌手尹相杰涉嫌非法持有毒品案于今日上午9时在北京市朝阳区人民法院依法公开开庭审理。对公诉机关指控的事实和罪名，尹相杰均无异议并自愿认罪。法官当庭宣布，尹相杰因非法持有毒品罪，一审获刑7个月并处罚金2000元。	歌手尹相杰非法持有毒品一审获刑7个月
在回答有关工商局和淘宝争议问题时，国家工商总局副局长刘玉亭表示，互联网企业要加强与政府有关部门的沟通，积极反映发展中遇到的问题并提出积极有建设性的意见和建议，政府有关部门要加强对企业的指导。	工商总局回应与淘宝争议：政府要加强对企业的指导
今天湖南沅江市检察院对陆勇涉嫌“妨害信用卡管理“和”销售假药”案做出最终决定，认为其行为不构成犯罪，决定不起诉。陆勇因给千余网友分享购买仿制格列卫的印度抗癌药渠道被称“抗癌药代购第一人”，后被检方起诉。	检方决定不起诉“抗癌药代购第一人”
《互联网用户账号名称管理规定》将于3月1日正式施行。昨日，国家互联网信息办公室有关负责人表示，多家互联网企业近日已处置微博客、博客、论坛、贴吧和即时通信工具等各类违法违规账号6万余个。	网信办：“账号十条”将施行多网站自查6万个违规账号
下周最高法第一巡回法庭将开庭审理第一宗案件，最高法巡回法庭历史上的首宗案件，有怎样的特别之处？巡回法庭将首次实行主审法官、合议庭办案负责制，这意味着第一宗案件主审法官将敲响这一制度历史上的“第一槌”	最高法第一巡回法庭将开审首案：跨省买卖合同纠纷
针对政府采购活动中也暴露出质量不高、效率低下等问题，特制定该条例，完善政府采购制度，进一步促进政府采购的规范化、法制化，构建规范透明、公平竞争、监督到位、严格问责的政府采购工作机制。	政府采购法实施条例3月1日施行
公安部会同国家网信办、工信部、环保部、工商总局、安监总局制定出台《互联网危险物品信息发布管理规定》，进一步加强对互联网危险物品信息的管理，规范危险物品从业单位信息发布行为。规定自2015年3月1日起执行。	新规：禁止个人在互联网上发布危险物品信息
银行卡含有大量信息，例如公民个人身份信息、账户信息等。能否收藏他人银行卡，收藏都有哪些法律风险以及容许自己的卡进入收藏流通领域对于持卡人会不会具有不利法律后果等问题？戳长微博了解↓↓↓	收藏银行卡隐藏多重法律风险5张以上就有可能犯罪
说起熊孩子，就想到“牛爸爸”。1月23日傍晚，因女儿要结婚，在公园保安部当部长的老爸就可以开方便之门，让客人把车停到公园里面。八项规定都这么久了，这位保安部长还敢这么干，可真是位“牛爸爸”。	“熊孩子”VS“牛爸爸”
已经步入2015半个月了，冬天也过去一大半了，接下来我们就要好好“筹备”一下2015春装的事儿。蕾丝绝对是不能舍弃的元素，在现在这个乍寒乍暖的天气，南海君教你怎么用蕾丝搭配来丰富我们的细节吧！美丽猛戳	让蕾丝搭配来丰富小细节2015要继续美下去
1月31日之后，海口市物价局推出的30天平价菜的相关举措将暂停。但是问题来了，还有不到一个月时间就是春节了。“这个春节，我们还能吃到平价菜吗？”市民希望，这个春节也能吃到便宜、实惠的蔬菜，开开心心过春节。	海口平价菜促销将到期春节还能吃到平价菜吗？
杨桃富含对人体健康有益的维生素A、维生素C以及各种纤维质可惜满满几千亩杨桃还在田间无人采摘农民伯伯好伤心。这个周末，我们一起去澄迈摘杨桃咯！！游玩自驾采摘全都不拉下报名请戳→_→→_→	这个周末，一起去澄迈摘杨桃
羊年新春后，中国房产、财税、工商等领域一批新政将密集实施：《不动产登记暂行条例》将于2015年3月1日起正式实施；《侵害消费者权益行为处罚办法》将于2015年3月15日起施行	房产、财税、工商等多项新政羊年新春后落地
三亚男子和朋友骑摩托车，引发后面摩托车男子故意戏弄，后车超车并“蛇形”驾驶，还恶意踢倒前车。致前车男子六级伤残。交警提醒：驾驶电动车“蛇形”超速行驶，不但面临扣车罚款，当事人可能被拘留，构成严重后果的还将被追究刑事责任。	三亚“飙车党”蛇形驾驶致人六级伤残
最高人民检察院日前出台意见指出，将积极推动反腐败国家立法，完善惩治和预防腐败体系，形成不敢腐、不能腐、不想腐的有效机制。推动完善惩治贪污贿赂犯罪法律制度，把贿赂犯罪对象由财物扩大为财物和其他财产性利益。	最高检推动反腐败国家立法
海南省气象台01月25日18时05分发布大雾橙色预警信号：琼州海峡6小时内可能出现能见度小于200米的雾，或者已经出现能见度小于200米、大于等于50米的雾并将持续，请交通、航运等部门注意做好防范措施。	海南发布大雾橙色预警
小学期末测试临近，不少学校老师在给学生加压。陆续有学生家长向记者反映：小学生每天都要捧两三张试卷回家，晚上10点前根本做不完。为让孩子早点睡，有的家长竟然帮着孩子写作业……	期末临近海口小学生作业多家长忧负担太重帮作弊
近日，海口市民反映：“海口电动车越来越多，但这些车往哪里停？海口的电动车停车场存在太多问题，很不规范！”划出块地就收费？占道经营收费乱？海口电动车停放点乱象重重，谁来管管呢？	海口电动车划块地就收费？谁来管管这乱象……
眼下距离不动产登记暂行条例实施时间不过半个月。国土资源部近日披露，由多部委共同组建的不动产统一登记联席会议明确提出，新旧证交替阶段不能乱，要尽快颁布统一的登记薄册和证书，力争今年年底全面颁发新证书。	不动产登记进入倒计时具备发新证地方停发旧版证书
25日夜间到26日白天：北部，最低温14-16℃，最高温26-28℃；中部，最低温13-15℃，最高温26-28℃；东部，最低温15-17℃，最高温25-27℃；西部，最低温13-15℃，最高温27-29℃；南部，最低温15-17℃，最高温27-29℃	外套脱掉！脱掉！海南今日最高温直逼30℃
多肉植物的外形不仅玲珑讨喜，而且还有丰富的种类，各式各样的形状、色彩，让人眼前一亮、有“小清新”之感。这些“天然萌”的多肉植物将参加2015年海报集团年货展，希望“萌萌哒”的它们能给您增添一份生活乐趣。	萌萌哒多肉植物来啦快快带它回家吧
22日晚，今年34岁的女子小倩(化名)在派出所门口，向记者讲述埋在她心中十多年的一个惊天秘密：在她19岁那年，“干爹”符陶武(化名)将她强奸，以裸照要挟，在长达十余年的时间内，成为“干爹”的性伴侣。	海口女子报警：遭干爹强奸10余年为他堕胎5次
“4天了，孩子还呆在保温箱里，还没度过危险期，孩子的妈妈也在住院，正为后续治疗费发愁。”据悉，同卵三胞胎，比中百万巨奖几率还低，早产的三姐妹都在危险期，孩子爸妈却再拿不出治疗费了！好心人如愿捐款，请拨：966123。	海口罕见同卵三胞胎早产病危盼救助
1月23日，海南环岛西线高速公路儋州市白马井立交至海头互通之间路段，公路维修改造工程正紧张有序推进。据悉，目前整个路段维修改造工程已经接近尾声，预计春节前将全线完工通车。	海南西线高速修复预计春节前全线通车
经海南省民政厅批准，三沙市近日在永兴(镇)管委会设立三沙市婚姻登记点。不久后三沙市干部职工、社区居委会居民和驻市部队官兵均可在永兴岛办理婚姻登记业务。哇！再远的距离我们也能相爱	再远的距离我们也能相爱
咖喱鱼蛋、鸡蛋仔、车仔面、双皮奶……香港街头常见的小吃，在2015年第二届海南年货展暨迎春庙会上也有啦。很Q的咖喱鱼蛋则是用特种咖喱粉混合各种秘制酱料，搭配正宗的台湾鱼丸煮熟后食用。不贵，好吃又管饱。	地道香港街头小吃现年货展
澄迈县红山农场及附近种植户求助：“因今年杨桃产量实在太多，却没商贩来收购；杨桃严重滞销”。如今每天看着很多熟透的杨桃自落树下，种植户们十分心痛。如有意收购者请联系：温先生(13976863776)；红山农场王先生(13016209381)	澄迈几千亩杨桃滞销急盼买家
针对一些婚恋网站屡现违法违规和严重失信行为的问题，为依法打击网上婚恋网站乱象，维护群众合法权益，促进网络诚信建设制度化，国家网信办联合有关部门在全国范围内启动开展“婚恋网站严重违规失信”专项整治工作。	国家网信办开展“婚恋网站严重违规失信”专项整治
4G网络快不快?测测才知道!1月22日，南海君和5位微博大V一起来到了海口市万绿园和上邦百汇城，用中国电信、中国移动、中国联通这三家运营商的4G网络进行测速体验。4G网络哪家强？欲知	微博大V体验4G极速网络
2014-2015国际拳联WSB世界职业拳击联赛常规赛第二轮暨里约奥运会资格赛将于明天在三亚开打，中国龙队的5名选手将在三亚房博会展馆迎战A组的俄罗斯队的5名选手。世界级拳王有可能从这里起步！	奥运会拳击资格赛为海南房博会“打气”
1月21日21时，随着最后一段合龙段浇筑完成，拆除重建的东山大桥顺利合龙。一座全新大桥飞跨南渡江两岸，意味着海榆中线通行条件将大大改善。位于海榆中线澄迈永发镇内的东山大桥全长397米，大桥合龙后将转入桥面铺装，春节前有望通车。	海南东山大桥春节前可通车
家住海口市兴丹路的李先生每天都要开车经过红城湖路延长线，他对红城湖路延长线限速50公里表示非常不理解，认为周围热闹路段限速60公里、70公里，到这条车少人稀的路段，突然限速50公里，许多车主过红绿灯后来不及换挡，很容易就超速。	海口红城湖路延长线限速不合理
海南经济深观察最新一期节目很荣幸的邀请到了现任海南大学中国现代经济理论研究所所长，政协海南省委常委王毅武教授，王教授在这次访问中就最近火热的海南银行的设立以及克拉运河开通发表了自己的看法，	王毅武：开通克拉运河是天降大任于海南
1月21日起，《海南省厉行节约反对食品浪费的实施方案》印发，规定：公务用餐原则是实行自助餐，不提供高档菜肴酒水和香烟；单位食堂浪费要通报；餐饮企业主动帮助打包等等。公务员们，不能再大吃大喝了！	公务员们，要管好你们的嘴了
无论您是身在异乡的游子，还是足不出户的宅男宅女，又或是昼伏夜出的夜猫一族，好消息！2015年第二届海南年货展联合易买商城，推出网上年货展，让全国消费者随时随地都能买到地道的海南年货。亲！请管好自己的双手哦~	海南年货展网上年货大街开卖啦
1月21日中午12时许，在海口市金盘路与金牛路交叉路发生一起交通事故，一辆车牌号为琼A·FB0X5的奔腾B50轿车将53岁的王女士撞伤。当时交警及刑警人员都赶到现场处理，但后来肇事车辆却被海口市公安局开发区分局的刑警部门拖走……	怪事：车祸肇事车辆竟被刑警拖走
中国有个习大大，做梦都想见到他!可以说，海南是在习大大心目中占据着特殊位置的，他曾前后三次来海南，每次都给岛民们带来不同的惊喜和问候。这不，再过两个多月，博鳌亚洲论坛2015年年会举行，习大大又要来海南看我们了，岛民们不要太激动哦！	习大大又要来海南看我们了
海口市拟新建一座南海明珠大桥，全长2343.5m。此外还将拟通过填海造地形成南海明珠人工岛，拟建的南海明珠大桥是联系人工岛的重要通道也是进出人工岛的唯一陆路通道。	海口要建南海明珠大桥啦
鳌亚洲论坛2015年年会于3月26日至29日在中国海南博鳌举行。3月28日早上将召开年会开幕式，届时中华人民共和国主席习近平和各国领导人将出席，博鳌亚洲论坛秘书长周文重致欢迎辞，论坛理事长福田康夫做主旨演讲	博鳌亚洲论坛2015年年会3月26日举行设73场讨论
领导干部尊法学法守法用法，既靠自觉，也靠制度。要把能不能遵守法律、依法办事作为考察干部重要内容，抓紧对领导干部推进法治建设实绩的考核制度进行设计，把法治素养好、依法办事能力强的干部用起来。	人民日报评论员：领导干部要做尊法学法守法用法的模范
国家互联网信息办公室21日宣布，国家网信办、工业和信息化部、公安部、国家新闻出版广电总局联合启动“网络敲诈和有偿删帖”专项整治工作，力争用半年左右时间，着力解决这一损害群众利益、群众反映强烈的突出问题。	国家网信办等四部门专项治理网络敲诈和有偿删帖
海口15岁少女小意失踪半年后，案情终于有了进展。嫌疑人林某向警方供认：他将少女小意杀死在海口海甸岛一处工地上。警方根据供词线索，在工地找到一具尸体……他是谁？他为何如此狠心杀死少女小意？	海口15岁失踪少女小意找到了！只是她再也不能回家
一段时间以来，有人提出似是而非的观点，热衷于讨论“党大”还是“法大”，把“党”和“法”人为地对立起来割裂开来。对此，作为领导干部一定要表明政治态度，坚定政治立场，绝不能让“党大还是法大”这个伪命题干扰政治定力	新华社：绝不许“党大还是法大”伪命题干扰政治定力
儋州地处海南西部，气候宜人，常年平均气温23度，空气质量好。今年年底，西环高铁将会通车，目前，儋州的房价在全岛来说偏低。儋州那大中心城区的房价均价5000多元，而白马井滨海新区这边的均价在5800元左右。亲！带好信用卡来吧！	在儋州置业准没错
清香的米粉拌上滑而不腻的卤汁，再佐以秘制牛肉干和各色配菜，吃一碗地道的手工制龙塘粉不需要跑到龙塘去。在2015年第二届海南年货展暨迎春庙会上，就能尝到龙塘粉世家第五代传人王世伯亲手为您做的龙塘粉。	百年龙塘粉开到年货展
冬天来三亚看海，自拍神器还怕没流量？1月20日，细心的游客发现可以在三亚湾海月广场、大小洞天景区附近通过手机接入“无线三亚”WiFi网络，刷朋友圈不怕没流量。三亚还将免费WiFi逐步扩大三亚湾、大东海、亚龙湾、海棠湾等公共海滩	三亚海滩有免费WIFI海边自拍还怕没流量？
为应对即将到来的春运高峰，20日起，海口港在原有8个定点航班的基础上新增4个定点航班，时间段：每天01：30-24：00。各位旅客可拨打热线电话订票，同时海口港将实行滚动发班，每小时发2-5个航班。	海口港今日起再增四个定点航班
2015年26岁至35周岁的“80后”小伙伴们，今年是二代居民身份证大批量换证的一年，赶紧拿出你们的身份证看看，是不是快到有效期了?如你的身份证已到有效期，请尽快到其户籍所在地公安分局办证中心或派出所办理换发手续吧。	80后，你该换身份证了！
作为最高法有史以来条文最多、篇幅最长的司法解释，民诉法司法解释共２３章５５２条，对人民法院适用民事诉讼法的相关问题作了全面系统、明确具体的规定。这部“史上最长司法解释”有何看点？从以下七个关键词可窥一斑。	七个关键词看民诉法司法解释
马鲛鱼、大对虾、红石斑鱼、鲍鱼、大白鲳鱼、海立鱼等几十种来自三沙纯净海域的美味，将在2015年海报集团年货展上高调来袭，三沙当地流传这样一句话：“三沙归来不看海，三沙品完不吃鲜。”话不多说→_→#2015海南年货展#等你来	三沙优质海鲜产品重磅来袭
谢先生，日前接到厂家通知，将于2015年2月对他购买的速腾汽车召回进行打补丁处理。此举引起谢先生的质疑，据称，厂家召回的新速腾汽车，不更换有隐患的耦合杆式后悬架，而是在其上面安装金属衬板，汽车的隐患还是没有彻底地消除。	大众新速腾补丁方案引车主质疑
最高法今日公布《民诉法司法解释》。根据这部司法解释，网上聊天记录、博客、微博客、手机短信、电子签名、域名等形成或者存储在电子介质中的信息可以视为民事案件中的证据。自2月4日起实施。	短信、微博、网聊记录等可作民事案件证据
海南省小学从2015年1月31日起、中学从2015年2月7日起开始放寒假，中小学下学期报名注册时间为2015年2月28至3月1日，正式上课时间为3月2日。海南省教育厅要求，各中小学校一律不得利用寒假时间，组织学生进行集体补	海南中小学放假时间出炉了
1月19日，得胜沙路步行街街道办收取费用，允许流动摊贩在此营业，引发得胜沙路业主集体停业。得胜沙路是禁止流动摊贩在此营业的。经过调查，收取费用的行为是临时工私自行为，收取流动摊贩的费用已全部返还，业主们已经正常营业。	又是临时工？海口得胜沙路业主集体讨权利！
1月16日，省委常委、政法委书记、常务副省长毛超峰在海口主持召开中央驻琼单位座谈会，就将提交今年两会审议的《政府工作报告(征求意见稿)》征求意见建议。据悉，这是毛超峰首次以海南省常务副省长身份在媒体上亮相。	毛超峰任海南省常务副省长
“感动海南”人物评选已开展几年，一个个闪亮的名字和群体，用他们爱和正能量感动着所有人，传播着爱和正能量，弘扬着人性之美。在他们身上，我们看到了坚强和毅力，更看到了爱与责任，激励着我们每一个人	“感动海南”：以草根情怀弘扬人性之美
有村民举报，称三亚市南丁村一名村干部嫁女儿大摆宴席。记者暗访发现虽是在村里自办酒席，但婚宴酒桌数目在50桌以上。三亚市纪委表示，据中央规定，各级党员干部，包括村干部在内，办婚宴、乔迁、生日等酒宴都必须在6桌以内…	三亚村干部嫁女摆50多桌宴席遭举报超标了
“蜀生走了！”1月17日早晨6时许，一群熬夜写稿的记者和夜班编辑们在熟睡中被手机铃声惊醒。从四川省自贡日报到海南日报，32年从未间断过心中的新闻理想，临退休之际受命创建海南日报全媒体视觉中心，打造上百块示范新闻版。	海南“报痴”王蜀生走了：一生玩命干新闻刚退休
今日上午8点左右，海口一辆客运中巴车在海口红城湖烟草公司附近发生自燃，所幸的是车上4名乘客及时逃生，没有造成无人员伤亡。记者向现场民警了解到，车子自燃起火有可能是因为线路短路导致，但具体原因还在调查当中。	海口一客运中巴车发生自燃，只剩“骨架”
今天上午，有市民向南海网记者反映，海口金盘头铺菜市场路边一家“双汇”的猪肉摊被砸了，原因是这里的肉价太便宜。记者来到摊位，现场一片狼藉，帐篷已被拆断，猪肉零散一地，电子称也被砸坏。这...猪肉卖得便宜也不行？	海口：路边猪肉太便宜被砸了
“开着几十万元的豪车，居然连8块钱一碗的腌粉都不愿意付。”今天上午，市民李先生在海口蓝天路一家琼园鸡饭店，目睹到一男子驾驶捷豹轿车吃完东西“逃单”的一幕。当时就惊呆了......那辆黑色的捷豹价值至少价值70万元啊	海口：男子开捷豹吃腌粉逃单
英国时间一月17日的下午，周杰伦昆凌于英国SelbyAbbey教堂举办婚礼，在两位牧师的见证下，两人互换戒指，交换誓约，完成了终身大事！还记得，80后90后的青春里有一个人叫周杰伦，他的歌几乎伴随了整个学生时代。昆凌，照顾好我们的青春	周杰伦昆凌婚啦！
16日起，机场将专门提供旅客在停车场与航站楼之间免费乘坐的纯电动旅客摆渡车，每20分钟一趟，行车路线为：国内候机楼到达厅C口至停车场收费口出口处往返，全程行车时间约为10分钟。	美兰机场开通停车场-候机楼免费摆渡车啦
海口某航空售票处一名负责人郑某帅，以高额回报为饵，大肆向身边熟人“借款”，总金额或达上千万元，引起海口警方的关注。日前，犯罪嫌疑人郑某帅已投案自首。昨日接受采访时，他表示后悔，称自己给自己挖了一个坑，希望得到受害者的原谅。	借上千万元跑路的人自首了！
有“抗癌药代购第一人”之称陆勇为千余网友分享购买印度抗癌药渠道，于去年7月因“妨害信用卡管理”和“销售假药罪”被检察机关起诉。检察机关现已撤回诉讼，陆勇获释>>>	“抗癌药代购第一人”已获释检方主动撤诉
新《车辆购置税征收管理办法》将转变职能下放管理权限，优化流程减轻办税负担；食品生产经营者的主体责任将强化，食品安全承检机构应当对检验工作负责；重大税务案件当事人要求听证必须组织听证…2015年2月1日起，一批法律法规将开始实施	一批法律法规2月1日起实施
根据社会举报，中国记协近日查处了中国经营报、南方周末、中国产经新闻等媒体3起虚假、失实报道。涉事媒体与记者有的报道失实，有的偏听偏信、断章取义；有的甚至故意编造虚假内容，有关行政主管部门正进行立案查处。	中国记协通报３起虚假、失实报道
中国民间文化艺术之乡、海南琼剧之乡——定安的一帮琼剧票友将为逛年货展的市民免费送上一场琼剧大戏。定安是琼剧文化之乡，黄竹镇素来有浓厚的琼剧文化氛围，无论老少都爱学、爱听、爱唱。戳链接（）跟着南海君一起来体验一番！	来，感受一下传统的“海南戏”
“感动海南”人物评选已开展了几年，一个个闪亮的名字和群体，用他们爱和正能量感动着所有人，传播着爱和正能量，弘扬着人性之美。作为主办的媒体，无疑也用独特的视角和情怀在感受和记录着这些浓浓的善与爱。	“感动海南”：以草根情怀弘扬人性之美
针对黑龙江讷河监狱案暴露出的内部管理问题，司法部部署，将全面加强监所管理，并在全国监狱戒毒场所开展违禁品、违规品专项清缴和严明纪律严格履职专项教育等活动。私带违禁品给罪犯的干警一律开除!	司法部：认真汲取讷河监狱案件教训全面加强监所管理
1月15日“感动海南”2014年度人物揭晓，再一次让这个充满爱和善的岛屿绽放光芒，省委书记“为凡人善举点赞为草根英雄站台”，激励和鼓舞更多人加入到传递爱和正能量的行列。带话题#为海南凡人善举点赞#转发有惊喜！	传递海南正能量转发也是一种力量
去年5月12日，中国公证协会印发《关于进一步加强以公信力建设为重点的公证行风建设的意见》。随后，全国公证行业因地制宜开展了一系列实践活动，基本做到了全面布置、全员参与、全面检验、全面提升。	全国公证行业：开门实践让群众感知公信力
“感动海南”“感动你我”……今晚“感动海南”2014年度十大人物评选颁奖典礼已圆满结束了。2015年，我们将继续为凡人善举、美德义行点赞，让我们一同致敬这群最可爱的人。	致敬！“感动海南”这群最可爱的人
春运是全年客流量最集中的时期，也是道路交通事故易发高发期。针对春运期间最易导致事故的八类交通违法行为，公安部交管局２７日公布了一批近年典型案例，提醒每一位春运交通参与者安全文明出行、平安回家过年。	一批春运道路交通事故典型案例公布
最高法院第一巡回法庭将于今天上午在深圳正式挂牌。根据中央批准的试点方案，最高法第一和第二巡回法庭分别设于广东省深圳市和辽宁省沈阳市，两个巡回法庭将于今年年初开始受理、审理案件。	最高法第一巡回法庭今日挂牌判决效力等同于最高法
“感动海南”2014十大年度人物评选活动，1月15日晚将现场揭晓感动海南十大人物获奖者。南海网将全程进行图文滚动报道，视频直播！PS:与感动人物共同分享成功的喜悦容易留下泪水，入场观众务必提前准备好纸巾或小手绢。	“感动海南”2014十大年度人物今晚直播
昨天，中国银监会批复同意海南筹建海南银行股份有限公司，海南银行前身是临高金牌城市信用社。银行30亿股总股本中民营股份占53%。以重点服务中小微企业和城乡居民为市场定位。同时将互联网金融作为海南银行未来发展的重点方向之一。	海南银行获银监会批准筹建
12月28日22时，英超第19轮展开角逐，切尔西客场挑战南安普顿。上半场马内的轻巧为圣徒先拔头筹，半场行将结束时，阿扎尔利用个人能力为蓝军扳平比分。下半场圣徒中场施耐德林累积黄牌离场，但众志成城的南安普顿最终抵挡住了切尔西的攻势，双方1-1握手言和。	南安普顿1:1切尔西
9月22日，省环保厅公布了全省8月份的空气质量排名，整体8月份的空气质量好于7月份。从城市环境空气质量优良天数排名来看，18个省辖市中，周口一天不落以31天的优良天数排名首位，漯河虽然20天好天气，但排名末位。	河南8月份空气质量排名周口天天都是优良
今年的CES，最大的主角就是智能汽车了。早在展会开始之前就爆出谷歌和奥迪的恋情，二者将一同开发基于Android的车载信息娱乐系统。随后“阴谋”扩大，谷歌宣布组建开放汽车联盟，联盟包括奥迪、通用、本田等汽车产商。对汽车仪表盘的争夺战在打响。	汽车才是新的“智能手机”
每年只有一次五天的年假，去不了太远的地方。和闺蜜商量之后，因为去年去台湾时顺便办的港澳通行证很方便，决定把今年的旅行交给有美誉的“东方之珠”（by:hitobito)→→→	#香港自由行攻略#：与闺蜜HK游（美食、景点、多图详说分享）
CES上展出的华为Memo路由，除了充当路由的角色外，还能作为家庭存储中心。让手机照片、视频直接传到路由器上的硬盘上，路由器同时又将数据备份到云端存储。此外，还提供了功能按键，只要按下该键，就能将设备中的数据自动复制到路由器内置的硬盘中。	华为智能路由器Memo初体验
8月10日晚上9点左右，在呈贡新区森宝公司做保安的22岁小伙白永生在回公司路上，途经一家饭店门前时，被6个不明身份的青年男女用刀捅伤（身上被捅4刀），造成白永生右手臂、胃部和小肠不同程度受伤，而行凶男女则乘一辆黑色小汽车逃逸。	呈贡小伙无故被捅4刀无妄之灾？
杭州的任老师感觉，现在的男孩不够男子汉，说话娘娘腔，还经常告状被女生虐。之后，他做了两年调查发现：家庭对男孩过分严厉，管理专横，会导致男孩的独立自主性被忽视，胆小怕事。大家说说：#女汉纸#为什么变多了呢？	男孩为何娘娘腔？调查称与家长专制有关
16号早上九点多的直通车，到红磡十一点，首先奔向尖沙咀SOGO。人没有铜锣湾那么多，但也绝对拥挤，收银台都是排着长队的。于是我先挑人少的专柜开买。废放少说，上图上真相（by：猫咪longer）	#SOGO周年庆#周末两天#香港购物#一箩筐
Fandy毕业于广州美术学院，学的专业是工业产品设计，设计过一些产品的外观，做过互联网的交互设计。设计师出身的Fandy具有很好的创意天赋，设计出的产品经常受到客户的高度评价。在积累了一定的经验和人脉关系之后，2011年下半年Fandy决定自己创业。	美立知Fandy的创业之路
珠钗摇曳、裙裾飞扬，在充满汉代风情的音乐诗篇中，9月20日，72对新人在新郑黄帝故里举行了别具一格的集体婚礼。 在象征传统“结发礼”的“解缨之礼”环节，新郎为新娘解去头上的缨簪。象征着夫妻二人将永结同心，一生厮守。	72对新人在新郑喜结连理 集体婚礼穿越回汉代
风光无限的各大厂商参与的CES大会，诺基亚雄风不在，只在门外摆地摊，档口冷冷清清，免费派送手机也无人问津。冰冻三尺非一日之寒，诺基亚今天的状况，恰恰是其风光无限的时候埋下的种子。科技以人为本，最后落得只是一句口号。	诺基亚没有以人为本
日前，晚报报道了现代“山顶洞人”惊现曲靖沾益，69岁老人王绍林21年来隐居山洞，过着“山顶洞人”的原始生活，当地领导干部多次劝其搬到养老院，但老人一直不肯，只愿住山洞。23日，经多次劝说，王绍林终于离开了自己隐居的山洞，住进养老院。	老人告别山洞搬新家
Faraday自行车会让你对电动自行车的看法完全改观，它外观漂亮，功能也不输一般的电动自行车。能实现这一点是因为它的发动机安装在前轮上，而电池实际上在框架内部，看起来和一辆普通的自行车没有多大差别。视频：LFaraday：你看的出这自行车是电动的吗？	Faraday：你看的出这自行车是电动的吗？
9月21日下午，新疆托克逊县境内一辆面包车和卡车相撞，面包车上8人全部遇难，除当地司机外，另7人均为开封岳王庙乡人，其中有一对母子，儿子十六七岁。他们是跟随老乡一起去新疆吐鲁番摘棉花的。遇难者家属正在赶往新疆。	开封7名老乡新疆遭遇车祸遇难
法新社和亚足联官网均刊登了中国男足的专题文章，主教练佩兰在接受采访时承认国足本次夺冠希望渺茫，法新社也认为在预选赛中国足仅赢了两场，不具备和日韩抗衡的实力，亚足联官网则称国足将面对沙特、乌兹别克斯坦和朝鲜的全力合围。	外媒看衰国足：预选赛赢2场，佩兰也没信心
“在北欧一些国家，人们在一个星期里工作四天，休息三天。依据我国现在的经济增长速度，哪怕经济增速低一点儿，如果每年能增长6%，到2030年，我国就可以实行工作四天、休息三天的制度。	人大教授：按中国发展速度2030年可工作4天休3天
酷派今天推出电商品牌“大神”以及两款手机：酷派大神和大神F1。其中大神使用7英寸全高清屏幕(1900*1200像素)和联发科MT6592八核处理器，并配备2GB的RAM，售价1888元；大神F1使用5寸720P屏幕、八核处理器，售888元，将于1月15日预约1月20日开售。	酷派推出独立电商品牌“大神”
任意球大师儒尼尼奥表示，他认为尤文中场皮尔洛是任意球方面的艺术家，而他完全配得上金球奖的荣誉。皮尔洛在任意球方面非常全能，”儒尼尼奥对《都灵体育报》说道，他是任意球专家，艺术家，他已经在这一方面达到了顶级水平。	儒尼尼奥：皮尔洛是任意球方面的艺术家
60岁的美国国籍天使投资人薛蛮子涉嫌嫖娼被抓，律师称应按治安管理处罚法，处以10日以上15日以下拘留；情节较轻处以5日以下拘留，外籍人构成违法，不排除警方据规定附加适用其他法律，如令其限期出境，驱逐出境。	律师称外籍人士违法可驱逐出境
日前意甲拉齐奥前锋克洛泽接受了德国媒体的采访，采访中克洛泽表示自己在冬季转会窗口中不会离开拉齐奥，但同时克洛泽表示如果需要尽快找回状态需要更多的出场时间。“当我最多只能踢半场比赛的时候，这并不够。这样不能保持节奏。	克洛泽：每场比赛只踢半场难以找回状态
“今晚至吉首市，一路上土族、苗族寨都很多，我好几日没给家里电话了……”这是骑行爱好者唐宝田的QQ说说，他从安徽省皖西学院骑车出发打算到云南旅游，可到湖南省吉首市后同学们就与他失去了联系，20多天过去了，目前仍无音讯。	安徽大学生欲骑车来云南失联20多天
2013年国产手机品牌层出不穷。如何从中脱颖而出？也许青橙NX的成功能给各个品牌商一些思考。青橙NX软硬兼施，在硬件上均采用国际一流供应商的豪华配置，在软件UI上更是后起之秀。正是这个UI设计，为青橙夺得“天极网-2013年度最佳UI设计产品”奖。	青橙NX获UI设计产品大奖
今日零时许，湖南临澧一中高一学生龙某、游某从宿舍楼坠地死亡。官方公告称：二人入学后均感到学习压力过大，成绩与家长和自己的期望落差较大，于是产生厌世情绪，相约自杀。——唉，死都不怕，何惧考试？愿：天堂里没有学习压力！	学习压力大 两名高一男生跳楼自杀
哈尔滨道外公安分局警察与“特情联手，多次对拒不供述嫌疑人电击、灌芥末油，致1人死亡。嫌犯回忆：“他们拿老式电话机，上面接出两根电线，把电线绑在我的脚趾上摇电话，我浑身抽搐，电了我七八次。	哈尔滨警察刑讯逼供：老式电话机电击，灌芥末油，鞋底抽打
无论严寒酷暑，每到清晨，昆明月牙塘小区的健身走廊里，总能见到一群年过半百的老人矫健身影，他们在各种健身器械上玩出各种高难度的花样，被人们称为月牙塘里的“杠上花”。这群老年人各怀绝技，什么二指禅、俯卧撑、引体向上、空翻、倒立……	月牙塘玩极限“杠上花”
据《星岛日报》驻北京记者消息23日19时许北京市公安局接群众举报在朝阳区安慧北里一小区内抓获卖淫嫖娼嫌疑人薛蛮子男60岁美国国籍、张云女22岁河南人二人对违法行为供认不讳。经了解薛蛮子真名薛必群。	北京警方称薛蛮子因涉嫌嫖娼被抓获
来自巴斯克的西甲升班马埃瓦尔本赛季的表现可圈可点，目前他们是五大联赛中排名最高的升班马。在主教练加里塔诺的率领下，他们在16场比赛中获得20分，排在西甲第九。埃瓦尔的排名也压过了巴斯克地区的邻居毕尔巴鄂和皇家社会。	埃瓦尔是五大联赛中排名最高的升班马
22日，晚报刊登的调查报道“大观渔火夜舞扰民报警都没用”引起强烈反响，很多市民又反映在昆明其他地方也存在夜舞扰民现象，并希望相关部门能赶紧管管，甚至连跳舞、领舞者都反映夜舞确实扰民，并就管理方面建议社区牵头引导管理。	夜舞扰民跳舞者都受不了了
郑州西三环半年连塌14次，专家直言离15塌不远了！会不会有16、17……连塌？不无可能！连塌原因还没有找到，也不知道责任人是谁，更无人被问责。首塌至今都快半年了！是查不出来，还是不想查？这个问题不解决，“连塌”可能无休无止！	14连塌，谁的责任？
截至昨日16时，西双版纳傣族自治州当日新增确诊登革热感染病例51例，是自15日发现首例以来新增病例最多的一天，累计病例已增至257例（含输入病例6例），累计疫点增至38个。累计住院治疗96例，累计出院患者19例，其他患者在门诊或居家隔离治疗。	西双版纳登革热疫点增至38个
2015年的非洲杯即将打响，但前切尔西前锋塞内加尔球员登巴巴却没有入选国家队大名单。对此登巴巴非常不满，他也在个人主页上言语抨击塞内加尔主帅吉雷瑟。他写道：“我已经等不及他的借口，并且要一个一个地拆穿。	不满未被征召，前蓝军前锋抨击国家队主
20日早，郑州花园路，一头一米多高的梅花鹿引人注目。有人在快车道上发现了它，它跟汽车并排奔跑，速度比车还快。野生动物保护中心人员两次发射麻醉针，将它擒获。自称饲养该鹿的饭庄拿不出驯养繁殖许可证，正接受调查。	郑州街头惊现梅花鹿闹市狂奔速度超过汽车
世界首辆陆空两用车的公开试飞近日取得了成功。生产厂商介绍，相关产品最早2015年就能上市。该车收起两翼宽2.3米，高2米，地面行驶最高车速为每小时112.6公里。变身飞机后最高航速为每小时185公里。飞行时每小时耗油20升。	世界首辆陆空两用车试飞成功最早2015年上市
为了给即将出征亚洲杯的中国男足国家队壮行，国家队助理教练李铁向出征亚洲杯的全部队员以及球队教练组和所有工作人员每人赠送了一块自己签约品牌的定制版运动手表。落选国足23人大名单的冯潇霆、赵旭日、杨智等7人也同样获赠。	李铁赠国足全体定制手表，落选7人也获赠
近年韩国带起的「丰颊潮」风靡中港台，不少女星趋之若鹜！由二字头林夏薇到30出头薛凯琪，个个恢复少女生肌，最离奇是44岁王菲、49岁张曼玉，即使再憔悴消瘦，两颊苹果肌依然饱满红润。	#女星#们为少女脸不惜天价打美容针
白杨，栈道、雕塑、凉亭......郑州天河路与黄河大堤交叉口西约2公里，有座风景宜人却略显破败的公园。2012年5月已对外开放，可连指示牌都没有。惠济区林业局证实，该园目前处于无人管护状态。咱没事去逛逛，顺便捡捡垃圾，咋样？	郑州有座950多亩的滨黄河森林公园，谁知道？
研究发现，一周之内喝5罐啤酒，就会令大脑反应迟钝20%。经常喝啤酒会永久抑制大脑的注意力。成人每次喝啤酒最好不超过300毫升（约一个易拉罐的量），一天不超过500毫升（约一瓶的量）。不要冰得太厉害，最适宜温度在12℃～15℃，喝时最为爽口。	一周5罐啤酒大脑迟钝20%
从西广场到东广场被吐槽为世界上最遥远的距离，仅仅400米3分钟路程，坐公交要50分钟，打的要40分钟，摩的三轮15分钟但得逆行。据规划局公示，幸福路—操场街(京广路—一马路、敦睦路)将建成连通东、西广场的新通道。	喜大普奔！郑州火车站东西广场终于要建下穿隧道了
薄熙来案庭审进入第三天，证人王正刚、王立军出庭作证。公诉人、被告人及辩护人对王立军进行了1小时40分钟的交叉询问。央视播出的庭审画面显示，王立军对薄熙来涉嫌滥用职权犯罪的事实，作了证明，薄熙来聆听王立军作证，并进行询问。	现场视频：王立军与薄熙来当庭对质
013年，中国智能手机市场分外热闹，小米销量三年三大步从30万到700万，再到1870万，成为中国手机市场的巨头之一；华为经过两年的折腾步入正轨，几款产品都有不错的销量；2014年，智能手机会如何发展呢？我们来做一系列展望。	手机去哪儿？2014智能手机市场篇
根据邮报的消息，阿森纳已经准备好2000万英镑的报价重新追逐葡萄牙后腰威廉-卡瓦略。今夏卡瓦略曾被里斯本竞技标价3000万英镑，两家俱乐部的谈判破裂导致交易未能成行。卡瓦略同时能够胜任中后卫的位置，同时他也和曼联联系在一起。	英媒：阿森纳2000万镑报价葡萄牙后腰
美国一名37岁男子“死而复活”的奇迹热传。报道称男子在医院抢救了45分钟后被宣布死亡，但当其17岁的儿子高喊“爸，你今天不会死”后又出现生命迹象，5天后出院。医生们无法解释原因，病人自己说是“奇迹”出现。	儿子高喊“爸，你别死”！男子心脏停跳45分钟后奇迹“复活”
香港旺角步行街开放日要限制拉！据新闻网了解到，有八成受访的当区居民赞成缩减旺角行人专用区(步行街)行人专区开放日数，有区议员认为，要优先考虑对居民作息时间的影响。	#香港旺角步行街#开放日将被限八成居民赞成限制
此次CES上展出了一个小东西LumoLift，这个专门的设备可以侦查你的身体位置，当你开始无精打采的时候，传感器会通过振动来让你挺直肩膀、抬头挺胸！且Lift这个东西可以内置在汗衫、衣领或者内衣带子上面，非常迷你。	姿态矫正设备LumoLift
争议又起。其实，早在近30年前首批高校军训时就已有阅兵。仪式产生神圣感，泛滥又损害神圣感。学生军训搞阅兵未尝不可，但不能太张扬——若只搞分列式（首长们坐主席台上）而不举行阅兵式（校长乘坐阅兵车），相信不会引起争议。	学生军训不宜“阅兵式”
加湿器在北方可以算是家家不可或缺的神器之一，其地位大致跟南方的暖宝宝相当。但这两类产品，大部分厂商遵守的原则都是能用就行——大家都无差异。Roolen就出了一款有特质的加湿器——地根据房间的状态调节湿度。	Breath：小家电的人性化路线
据意大利《共和报》报道，拉齐奥愿意用年轻新星奥纳齐交换利物浦前锋博里尼。2奥纳齐是一名尼日利亚国脚，他此前曾表示自己愿意加盟利物浦。而23岁的博里尼在利物浦经过了数月的板凳生涯，他正在考虑重回意大利。	意媒：拉齐奥愿用22岁中场交换博里尼
电视购物里“只要199元，就能买6件”的“金首饰”，经检测镉超标3000倍，还检出含大量有毒元素镍、铅。这些元素的组合，使“金首饰”有了黄金的色泽，却可能致癌，千万别买！有些卫视被通报过差不多200次，还在放此类广告，良心呢？！	电视购物金饰品，含毒不含金，别买！
电源线+电池+智能回路=Jump。一个能给自己充电的智能电源线。简单来说，这是一个一石二鸟的充电模式。当我们想打一个紧急电话，发一条讯息或者是想在地图上找到自己的位置时，常常要面对的尴尬处境是：智能机没电。这使就需要携带这样的充电设备。	Jump：能够自动储电的电源线
皇马大脑莫德里奇在萨格勒布儿童医院看望孩子们的时候接受了这个奖项。这已经是他第四次获得这个奖项（前三次分别在2007、2008和2011年），以13票的优势力压第二名的曼朱基奇获得头名。这个奖项由克罗地亚退役的足球运动员选出。	莫德里奇第四次当选克罗地亚年度最佳运动员
由雷锋网、锋神榜主办的“雷锋网2013年度最佳应用评选”活动结果公布。最终结果通过编辑部统计网友投票的票数，并经过编辑部内部推荐确认，雷锋网2013年度最佳应用评选的各项最佳都已经决出。	雷锋网2013年度最佳应用评选结果公布
半年来郑州西三环已14次塌方。目前路面又再次凹陷和沉降，现场勘查专家直言：“离15塌不远了！”郑州市政府已召开多次专题会议，可疾患始终得不到根治。“政府一直说要独立调查，可结果呢？”网友：难道非等出了人命才解决问题？	郑州西三环半年连塌14次一定要等到出人命吗？
钟汉良主演《最美的时光》在千呼万唤的期盼中在11.20唯美接档，近日，一组钟汉良与女主角张钧甯的吻戏曝光，尺度诱惑。下面就让我们一起来回顾下钟汉良往日那些大尺度镜头吧。	图集：披露#钟汉良#大尺度镜头舌吻摸身扑倒全集合
调查发现，网络成了买卖二代身份证的主要集散地。身份证主要来源于外来人口聚集的地区，一般为小偷作案后遗弃，被环卫工人或废品收购站收集起来卖给网络“卖家”，主要供未成年人上网、办理银行卡等业务。	身份证网上叫卖有人向环卫工收购
眼下西甲联赛进入冬季圣诞假期，让我们来一起侃侃看看数据排行榜。c罗梅西不负众望，占据着榜单的前沿位置，而在2014-15赛季的头五个月中，一些低调的球员也凭借高光表现，给我们留下了深刻的印象。	聚焦西甲：2014-15冬歇期数据大集合，球星大乱入
圣诞将至，一向以「年轻、流行、个性」的鲜明形象见称的Za，自1997年，不断开发护肤、彩粧产品，以简单步骤，令女性轻易提升独特美，让您散发独一无二的自信魅力→→→	#香港购物#妆品报价：Za#彩妆#系列打造极致圣诞粧容
在2013年夏天错失贝尔后，曼联一直没有放弃追逐，而现在皇马已经知会他们：只要罗伊斯能顺利加盟皇马，贝尔就可售。但是，皇马点名要求将德赫亚加入交易。他们钦点24岁的西班牙人为卡西利亚斯的接班人。	英媒：皇马要求曼联将德赫亚加入贝尔交易
可穿戴设备和智能软硬结合项目成为新宠之后，智能家居又重新被巨人们从垃圾堆里捡出来，现身今年的CES。很多的公司把一些产品和概念包装，纷纷推出SmartHome的口号。但实际上，很多所谓的智能家居产品别说可用性，连未来的可扩展性和可改良性都谈不上。	CES之智能家居观感
一名17岁河南洛阳女孩流浪银川街头，民警发现女孩左臂上的文身记录了其家庭住址和电话。22日，女孩母亲接到民警电话后赶赴银川接女儿。母亲说，女儿智力发育迟缓，一直没治好，7岁起就总是离家出走，文上住址和电话，遇到好心人就能找到我们。	妈妈把爱“刺”在女儿身上！
09年5月，薄瓜瓜被评为首届英国“十大杰出华人青年”，获大本钟奖。接受《青年周末》采访时，薄瓜瓜说在英国时住处条件比较苦，像贫民窟，饿坏了晚上就把枕头套扯下来，悄悄跑到厨房，看到有什么吃的，捡回来和同学一块分享。	旧闻：薄瓜瓜自称在英国住处像贫民窟饿得捡剩饭
最近新浪微博与支付宝的合作，多数砖家将其与微信支付进行PK。个人觉得，不妨放开眼界，从支付行业和消费习惯来看，微博与支付宝的“超级支付”概念，将极大提升用户消费效率，并养成移动支付习惯，传统pos机支付或许是时候退出历史舞台了。	超级支付：让POS机滚出“支付”圈
曾以清修苦行“不捉金钱”而闻名全国的辽宁大悲寺再度被舆论推上风口浪尖，多名网友在多个著名网络论坛发表文章，质疑大悲寺上下两院的僧人表面清苦实际奢华，苦修有作秀之嫌，更有网友曝其自称不捉金钱实则疯狂敛钱，收受居士捐款。	网曝辽宁大悲寺敛财千万居士生活如奴隶
目前正值葡萄大量上市，很多人除了吃葡萄外，还将葡萄酿成葡萄酒来饮用。但葡萄酒专家表示，自酿葡萄酒不仅会产生微量的甲醇，更因不能添加二氧化硫进行杀菌，导致自酿葡萄酒产生细菌，长期喝会对人体有危害。	自酿葡萄酒对身体有害！小心！
所有熊猫都是黑白色的吗？答案是“NO”。在陕西野生动物研究中心，熊猫“七仔”的皮肤是棕褐色的。专家称“相对其它仅皮毛拥有棕色斑点的熊猫而言，七仔拥有完全棕褐色皮肤是格外罕见的”。网友：“终于可以拍彩照了！”	我和我的小伙伴们都惊呆了！熊猫也有棕色的？！
曼联中场卡里克表示红魔不会停止追逐切尔西以及曼城的步伐。“我们希望能够在积分榜上更进一步继续追逐切尔西和曼城。我们对于第三名并不满意，显然我们正在变得更好，我们需要保持这种势头。我们需要准备就绪，我们对自己充满信心。	卡里克：不会停止追逐切尔西曼城的脚步
AC米兰官方电视台米兰频道宣布，马德里竞技球员切尔奇即将租借加盟球队，而托雷斯则转投马德里竞技。切尔奇同意了这次转会：“切尔奇的谈判仍未官方宣布，但我们已经接近终点线，就差几毫米。”马竞将从米兰接手与蓝军的租借合约。	米兰频道：托雷斯-切尔奇交易只差毫厘
近日，一条大学男生的恋爱账目的微博很火！通过记者采访发现，正处于恋爱中的大学男生花费的确很大。多数人表示，没万把块闲钱慎恋爱！吃饭、送礼物是压在恋爱中大学男生身上的“两座大山”。小伙伴们，你怎么看恋爱花销？	大学生恋爱账目：没万把块闲钱慎恋爱？
wear是一款个人助听器，但它的价值不在于完全替代传统的助听器，而是通过这个产品让听障人士能够像正常人一样的对话。wear具有相当高水平的保真度，并且比市面上的助听器更便宜、更方便。	wear：让听障者能更好的对话
薄熙来：按证人及谷开来说法，我当证人面致电谷安排吞没500万，这不合常理。熟悉的人都知道，我是比较谨慎的人，说话都要求他们关手机。当面致电商定贪500万，最低水平的贪污犯也不会那样做，智商再低的贪污犯也要问清还有谁知道。	薄熙来：智商再低的贪污犯也不会那样贪500万
今日，中国男足澳大利亚亚洲杯出征仪式在广州举行，这也是国足历史上首次举行亚洲杯出征仪式。中国足协副主席、中国队亚洲杯代表团团长魏吉祥表示，习近平主席高度重视中国足球，国足球员也深感责任重大，在亚洲杯上一定要为国争光。	魏吉祥：习主席重视足球，国足有信心争光
很多朋友跟我讲，如果不OpenWRT，哪这路由就没法儿用了！非常理解大家对OpenWRT的热爱，我做为一个开源项目的拥护者和参与者，今天来给大家讲讲路由器操作系统的那点事儿。让大家了解下各种固件的来由。	路由器操作系统那点事
利物浦主帅罗杰斯在接受采访时强调，他从未考虑过在冬季出售球队前锋巴洛特利。巴神在今夏转投利物浦后一直表现不佳，此前罗杰斯还表示巴神不适合球队的3-4-3新阵型，并要求他适应替补角色。还有消息称，国米主帅曼奇尼有意将巴神带回意甲。	罗杰斯：冬季出售巴神？从未考虑过
如果要对Google刚刚过去的2013年做个回顾，大手笔收购八家美国本土及海外的机器人公司可谓是其经营战略中浓墨重彩的一笔。过去一年，谷歌悄然收购了一批机器人和人工智能企业，其中不乏尚处初创期的创业公司。今天雷锋网就为大家介绍这八家机器人公司。	Google的机器人军团
国足主帅阿兰·佩兰在亚洲杯出征仪式上透露自己决定了本次23人名单的最后3个人选。他表示：“有20个队员是大家共同的选择，有3个球员我进行了选择。目标是要战胜每一个对手，赢得每一场比赛，最后回到布里斯班。	佩兰自曝亲定最后3人选，豪言小组头名出线
顾名思义，前锋是进攻线上的尖刀，他们有人擅长边路突袭，有人善于门前抢点；他们中既有动如脱兔的小个子，也有高大威猛的肌肉男。如果让你选出你心目中表现最佳的三人组成本年度虎扑最佳阵容的锋线三叉戟，你会作何选择？	虎扑足球2014年度11人评选：锋线篇
昨日，云南省纤检局组织专项行动，在昆明小街清棵村发现并捣毁了一个黑心棉加工窝点。另外，在螺蛳湾商品批发市场及呈贡大学城周边床上用品店查获了大量“黑心棉”。温馨提醒各位新同学，谨防一些骗子冒充“师兄”带你去买“黑心棉”。	新同学小心“师兄”带你买黑心棉
20日，省运会射击比赛在焦作体育中心射击馆举行，在女子乙组气手枪40发个人决赛中，来自三门峡的15岁小将严晓琦夺冠。在该组选手中，严晓琦是年龄最小的一个。国家队教练梁兵表示，如能善加培养，小严的未来不可限量。	省运会射击场三门峡15岁少女夺金
我省考古研究入选世界重大考古研究成果：马鹿洞发现多种类型人群并存，可能是目前世界上唯一案例。“马鹿洞人”，也叫“蒙自人”，1989年5月在蒙自县黄家山山腰发现，发掘出各类化石达100多千克。有4件保存较好的人头盖骨、下腭骨化石。	“蒙自人”沉睡一万年后“苏醒”
小小志，kimi，中文名：林嘉荣，男，2009年09月15日出生于美国加州长老医院。“亚洲小旋风”林志颖之子。《爸爸去哪儿》官方微博19日在微博上公布萌爸们写给孩子们的信→→→	人气萌宝#Kimi#个人档案#林志颖#萌爸信件曝光
仁川亚运会的泳池中，有众多河南运动员冲金的身影。河南小伙宁泽涛曾在孙杨、吕志武两大高手夹击中强势夺冠并刷新亚洲纪录，让中国游泳看到了实现突破的希望。此外，有机会冲击金牌、奖牌的河南泳将还有李昀琦、索冉、张馨予、李宇森等等。	河南泳将，加油！
汉诺威的德国国门齐勒日前在接受采访时表示，他目前只会专注于自己的比赛，不会考虑转会的问题。“我看到了很多有关于我的传闻，就像大家看到的那样，但是我只关注于我自己，这不会影响到我的比赛，就现在而言，我不会考虑转会。	齐勒：专注于比赛，暂时不考虑转会的问题
今天18时，仁川亚运会游泳比赛的首枚金牌将在男子200米自由泳项目上产生。孙杨与韩国选手朴泰桓的对决，自然成为本届亚运会的关注焦点。而日本媒体却认为，这不是两个人的对决，因为日本选手荻野公介也不容忽视。	亚运会泳池“三国杀”，你看好谁？
据意大利媒体报道，国米已经向阿森纳提出了200万欧元租借波多尔斯基，赛季结束后600万欧元买断的提议。国米总监奥西利奥目前正在伦敦与枪手高层进行商谈。波多尔斯基本人非常渴望转会，因为目前他在阿森纳队内实在难觅上场时间。	意媒：国米欲200万欧元租借波多尔斯基
5月，包括信阳籍农民工谢国良的儿子在内的9名非京籍初中生因不能报考北京市普通高中，将北京教育考试院告上法庭，一审被判败诉。9人提起上诉。昨天，北京市第一中院二审开庭，判决维持一审判决。专家认为，败诉根源还是教育资源配置的不均衡。	9名非京籍学生诉考试院二审败诉
从8月22日下午4点至23日下午4点，西双版纳新增登革热感染病例34例，境外输入病例1例（泰国输入）。从15日发现登革热至今，确诊为登革热的患者已累计达到206例，其中本地感染病例200例，输入性病例6例，无重症、死亡病例。	西双版纳登革热确诊病例增至206例
近日，魅族高调宣布了赴美参展CES2014的计划，黄章希望把办公室开到加州，把手机卖到美国已经不是一天两天的事了，在成功把手机卖到乌克兰之后，这边魅族又紧锣密鼓的开始筹备进军美国，面对成熟的美国市场，魅族准备拿什么去闯荡呢？	进军美国，魅族容易吗？
据悉，南水北调中线总干渠黄河以南段于昨日上午从南阳陶岔渠首正式开闸放水，丹江水于今日水头到达郑州境内的新郑闸门。提醒市民群众：要增强防范意识，不要进入总干渠游泳，确保自身安全和水质清洁。	丹江水终于到郑州了！
据西班牙媒体《马卡报》的消息，在这个圣诞节最受欢迎的礼物来自于皇家马德里，经过国际足联的认证，皇马的球衣将在右侧肩部绣上世俱杯冠军的标志。皇马的球员们将要在12月30日在迪拜对阵AC米兰的比赛中穿上这一新的队服。	皇马绣有世俱杯冠军标志球衣开卖
多位市民反映，武汉某小区保安昨天抓获一名小偷后，将小偷吊在墙头“示众”。不少住户也拍手称快，对此，物业李经理说，这么做主要是为了防止小偷在转送警方前逃走，保安并未殴打小偷。但律师称，此举不妥，有违法之嫌。你认为小区此举是否妥当？	保安捉住小偷将其吊墙头示众
20日，少林寺方丈释永信率众弟子在郑州举行“河南省少林文化交流中心新址落成”典礼。该中心以“都市禅堂”为载体，为都市人打坐禅修、少林养生、公益慈善等活动提供平台。释永信表示，城市大众修行的目的是放下烦躁的心，做该做的事。	少林寺推出“都市禅堂”你怎么看？
CES2014上，中兴发布了最新的5.5寸旗舰手机GrandSII。据了解，这款手机的最大卖点不是支持指纹识别，语言控制，而是支持声纹解锁。它的后置摄像头达到了1300万像素，电池容量达到了3000mAh。另外，它也支持目前的4G网络。	亮相CES中兴CES发布支持声纹解锁的四核手机
“过去工作上的问题和不足，我作为市长深表歉意，我们会认真总结，把工作做好。李文荣说。“下周一（8月26日）起采取临时措施吃上午饭，力争9月2日统一正式恢复小学午餐供应。	昆明市长李文荣为午餐问题致歉
中央电视台原台长杨伟光昨晚因病去世，享年79岁。他曾历任中央人民广播电台编辑、记者、副台长、中央电视台副台长、台长、广电部副部长等。他推动央视新闻改革，才有了当年的东方时空、焦点访谈、新闻调查、实话实说……	央视原台长杨伟光病逝曾打造焦点访谈
辽宁省防汛抗旱指挥部消息，截至昨日，大雨洪灾已致抚顺63人死亡，101人失踪。抚顺市政府昨日发布公告，8月24日为全市哀悼日，号召全市人民今日9时一起为遇难同胞默哀3分钟，届时所有防空警报将拉响，汽车停行鸣笛，行人驻足默哀。	抚顺洪灾164人遇难失踪今日全市哀悼
北京时间12月26日晚，曼城客场击败西布朗后，曼城“铁人”在球场内气温不足零度的情况下，脱掉球衣，将其抛给看台上的球迷，并向现场球迷鼓掌感谢。有曼城球迷在社交网站上表示：米尔纳是钢铁炼成的！	“铁人”米尔纳！
纽约部分华人彻夜排队倒卖爱疯6，一部能赚2000美元！稀缺导致投机，“黄牛”无可厚非。费解的是竟有那么多中国人愿意付出那么大的代价！早用几天那么重要吗？虚荣心有那么值钱吗？苹果虽可爱，消费需理性——可以“爱”，不必“疯”！	“果粉”，淡定！
在连续两场比赛为球队首开纪录后，穆里尼奥称：“我仿佛又看到了2004-2006那几年的特里！穆里尼奥说：“特里充满自信，他还像十年前一样。除了在训练场上看到她两个女儿的时候，我真不觉得他在球场上和10年前有何区别。	穆里尼奥：特里还是10年前的那个特里！
目前手环从功能上来说大同小异，整一年没什么亮眼的突破，只能从外形，制作工艺和噱头上下足功夫。极客发烧友们乐得尝试，大众消费者却似乎仍然兴趣索然，在这股声势浩大的热浪里自high的仍然自high，观望的持续观望，路过的依旧路过。	概念炒完手环还有猛料么？
10年间，来自宿迁的壮实大汉陈思，在南京长江大桥上救下了256个轻生者！从前两年开始，45岁的陈思越发觉得力不从心，他开始琢磨是否已经到了结束这份“事业”的时间，但从桥上走下之前，他想揭开一个埋在心底已经6年的秘密。	男子坚守大桥10年救256名轻生者
从理论上来看，医疗产业受益于人口老龄化、中国城镇化、居民收入水平提高及医疗资源分布不均等因素是医疗技术革新的基础。随着移动互联网技术的蓬勃发展，为医疗产业提供可延续性基础。同时，移动医疗为医疗产业提供广为丰富的想象空间。	移动医疗：想说爱你不容易